Year,Total,Percentage,ANY,LOW,MEDIUM,MEDIUM_HIGH,HIGH
2000,1019,0.2,2,0,0,2,2
2001,1676,0.18,3,0,1,3,2
2002,2156,1.44,31,0,5,31,26
2003,1527,2.62,40,0,7,40,33
2004,2451,5.88,144,1,26,143,117
2005,4932,8.92,440,1,47,439,392
2006,6608,10.81,714,11,155,703,548
2007,6516,9.33,608,2,117,606,489
2008,5632,17.4,980,2,154,978,824
2009,5732,14.38,824,1,122,823,701
2010,4639,9.27,430,2,37,428,391
2011,4150,6.36,264,0,34,264,230
2012,5288,3.59,190,0,56,190,134
2013,5187,2.47,128,2,38,126,88
2014,7937,3.0,238,3,100,235,135
2015,6487,2.68,174,2,81,172,91
2016,6447,1.23,79,0,58,79,21
2017,14643,2.2,322,5,133,317,184
2018,16509,1.96,323,2,160,321,161
2019,17305,1.97,341,4,142,337,195
2020,18350,2.45,450,10,175,440,265
2021,20155,3.11,627,17,287,610,323
2022,25050,6.15,1540,9,261,785,524
2023,28829,7.76,2237,0,0,0,0
2024,7533,7.82,589,0,0,0,0
